################################################################################
#..................#...............#...............#...................#.......#
#.S....#####...#...#########...#...#...#...#####...#...#############...#...#...#
#......#...#...#...........#...#...#...#...#.......#.......#.......#.......#...#
#..#####...#...#########...#...#####...#...#########...#####...#...#########...#
#..........#...........#...#...........#.......#.......#.......#.......#.......#
########..#########....#...##########..######..##.######...#########.####.######
#......#.......#.......#...........#.......#.......#.......#...........#.......#
#.############.#...#############...#################...#####...#######.#...#...#
#..............#...#...........#.......................#...#...........#...#...#
################...#..######..##########################..##########..######...#
#..................#...#...#...........#...........#...............#...........#
#..#############...#####...#############...#########...#...#...#################
#..............#.......#...................#...........#.......#...............#
###########...##..##..#################....#...################....#########...#
#..............#...#...#...................#...#...........#.......#.......#...#
#..#############...#...#...#################...#...#####...#...#...#...#...#...#
#..#...#...........#...#.......#...........#...#.......#.......#...#...#...#...#
#..#...#...#########...#########...#####...#...#########...#####...#...#...#...#
#..#...#...#.......#...........#.......#.......#.......#...#.......#...#...#...#
#..#...#...#...#...#########...#####...#########...#...#####...#####...#####...#
#..#...#...#...#...#.......#...........#.......#...#...#.......#...............#
#..#...#...#...#...#...#...#####...#####...#...#...#...#...#####...#############
#..#...#...#...#...#...#.......#...........#.......#.......#...#...#...........#
#..#...#...#...#####...#####...#############################...#...#...#########
#..#...........#.......#.......#...............#...................#...........#
#..#########...#...#####...#########...#####...#...#################...#####...#
#..........#...#...#...#...........#...#.......#...#...............#...#.......#
########..######..##..#########.#######...#...##..##############..##..##..#....#
#......#.......#...#.......#.......#.......#...#.......#.......#.......#...#...#
#..#########...#...#####...#...#####...#############...#...#...#...#####...#####
#......#.......#...#...........#...................#...#...#...#.......#.......#
####...#...#####...#...#########...#########...#...#...#...#...#####...#####...#
#......#...#.......#...........#...#.......#...#...#.......#...#...........#...#
#.######...#...#####...#...###.#...#...#...#...#...#########...#############...#
#......#.......#.......#.......#...#...#...#...#...........#...#.......#.......#
####...#########...#########...#...#...#...#...#############...#...#...#...#...#
#..............#.......#...................#...........#.......#...............#
###########....#...#...#################...#...#################...#########...#
#..............#...#...#...................#...#...........#.......#.......#...#
#..#############...#...#...#################...#...#####...#...#...#...#...#...#
#..#...#...........#...#.......#...........#...#.......#.......#...#...#...#...#
#..#...#...#########...#########...#####...#...#########...#####...#...#...#...#
#..#...#...#.......#...........#.......#.......#.......#...#.......#...#...#...#
#..#...#...#...#...#########...#####...#########...#...#####...#####...#####...#
#..#...#...#...#...#.......#...........#.......#...#...#.......#...............#
#..#...#...#...#...#...#...#####...#####...#...#...#...#...#####...#############
#..#...#...#...#...#...#.......#...........#.......#.......#...#...#...........#
#..#...#...#...#####...#####...#############################...#...#...#########
#..#...........#.......#.......#...............#...................#...........#
#..#########...#...#####...#########...#####...#...#################...#####...#
#..........#...#...#...#...........#...#.......#...#...............#...#.......#
#######....#####...#...#########...#####...#...#...#############...#...#...#...#
#......#.......#...#.......#.......#.......#...#.......#.......#.......#...#...#
#.##########...#...#####...#...#####...#############...#...#...#...#####...#####
#......#.......#...#...........#...................#...#...#...#.......#.......#
#..#...#...#####...#...#########...#########...#...#...#...#...#####...#####...#
#......#...#.......#...........#...#.......#...#...#.......#...#...........#...#
#..............#.......#...................#...........#.......#...............#
###########....#...#...#################...#...#################...#########...#
#..............#...#...#...................#...#...........#.......#.......#...#
#..#############...#...#...#################...#...#####...#...#...#...#...#...#
#..#...#...........#...#.......#...........#...#.......#.......#...#...#...#...#
#..#...#...#########...#########...#####...#...#########...#####...#...#...#...#
#..#...#...#.......#...........#.......#.......#.......#...#.......#...#...#...#
#..#...#...#...#...#########...#####...#########...#...#####...#####...#####...#
#..#...#...#...#...#.......#...........#.......#...#...#.......#...............#
#..#...#...#...#...#...#...#####...#####...#...#...#...#...#####...#############
#..#...#...#...#...#...#.......#...........#.......#.......#...#...#...........#
#..#...#...#...#####...#####...#############################...#...#...#########
#..#...........#.......#.......#...............#...................#...........#
#..#########...#...#####...#########...#####...#...#################...#####...#
#..........#...#...#...#...........#...#.......#...#...............#...#.#.#...#
#..#...#########...#########...#...#...#...#...#############...#...#...#.#.#...#
#......#.......#.......#.......#...#...#...#...#...........#...#.......#.#.#...#
#..#...#######.#...#########...#...#...#...#...#############...#...#...#.#.#...#
#..............#.......#.......#...#...#...#...#...........#...#...#...#.#.#...#
#..#...#########...#########...#...#...#...#...#############...#...#...#.#.#...#
#..#.......................#...........#...#.......................#.......#.E.#
################################################################################