####################
#S...........#.....#
#.#####.#.##.#.###.#
#.#.....#.##.#.#.#.#
#...#.#.#....#.#.#.#
#.###.#.#.####.#.#.#
#.#...#.#........#.#
###.######.#.###.#.#
#..........#...#.#.#
####.########.######
#....#.............#
#.#####.#.##.#.###.#
#.#.....#.##.#.#.#.#
#...#.#.#....#.#.#.#
#.###.#.###.##.#.#.#
#.#...#.#.#....#.#.#
#.#.#####.######.###
#.#...............E#
####################