###########
#S..#.....#
###.#.###.#
#...#.#.#.#
#.###.#.#.#
#.......#.#
#.#.###.#.#
#.#...#.#E#
###########

