##############################################
#S.................................#.........#
#.#########.#####################.#.########.#
#........#.............#.........#.#.........#
########.#.#############.#.#######.#.#########
#........#.#...........#.#.#.......#.........#
#.#######.#.###########.#.#.#.################
#.#.......#...........#.#.#.#................#
#.#.#################.#.#.#.##################
#.#.................#.#...#.#................#
#.###################.#####.#.################
#.................#...........#..............#
#################.#.###########.##############
#...............#.#.#.........#..............#
#.#############.#.#.#.#######.#.############.#
#........#.............#.........#.#.........#
########.#.#############.#.#######.#.#########
#........#.#...........#.#.#.......#.........#
#.#######.#.###########.#.#.#.################
#.#.......#...........#.#.#.#................#
#.#.#################.#.#.#.##################
#.#.................#.#...#.#................#
#.###################.#####.#.################
#.................#...........#..............#
#........#.............#.........#.#.........#
########.#.#############.#.#######.#.#########
#........#.#...........#.#.#.......#.........#
#.#######.#.###########.#.#.#.################
#.#.......#...........#.#.#.#................#
#.#.#################.#.#.#.##################
#.#.................#.#...#.#................#
#.###################.#####.#.################
#.................#...........#..............#
#################.#.###########.##############
#...............#.#.#.........#..............#
#........#.............#.........#.#.........#
########.#.#############.#.#######.#.#########
#........#.#...........#.#.#.......#.........#
#.#######.#.###########.#.#.#.#.##############
#.#.......#...........#.#.#.#................#
#.#.#################.#.#.#.###.##############
#.#.................#.#...#.#................#
#.###################.#####.#.#.##############
#.................#...........#..............#
#...............#.#.#.........#..............#
#.............#.#.#.#.#.....#.#.#...........E#
##############################################
