##############################################################
#..................#...............#...............#.........#
#.S....#####.#...#########.#...#.#...#####.#...#############.#
#......#.#...#...........#.#...#.#...#.......#.......#.......#
#..#####.#...#########.#...#####.#...#########.#####.#...#####
#..........#...........#.#...........#.......#.......#.......#
########..#########....#.##########..######..##.######.#######
#......#.......#.......#...........#.......#.......#.......#.#
#.############.#.#############.#################.#####.#######
#..............#.#...........#.......................#.#.....#
################.#..######..##########################..######
#..................#.#...#...........#...........#...........#
#..#############.#####.#############.#########.#...#.#########
#..............#.......#...................#...........#.....#
###########.##..##..#################....#.################..#
#..............#.#...#...................#.#...........#.....#
#..#############.#...#.#################.#...#####.#...#.#...#
#..#.#...........#.#.......#...........#.#.......#.......#.#.#
#..#.#...#########.#########.#####.#...#########.#####.#...#.#
#..#.#...#.......#...........#.......#.......#.......#.#.....#
#..#.#...#.#...#########.#####.#########.#...#####.#####.#####
#..#.#...#.#...#.......#...........#.......#.#...#.......#...#
#..#.#...#.#...#.#...#####.#####.#...#.#...#.#####.###########
#..#.#...#.#...#.#.......#...........#.......#.......#.#...#.#
#..#.#...#.#####.#####.#############################.#...#.###
#..#...........#.......#.......#...............#.............#
#..#########.#...#####.#########.#####.#...#################.#
#..........#.#...#.#...........#.#.......#.#...............#.#
########..######..##..#########.#######.#...##..##############
#......#.......#.#.......#.......#.......#.#.......#.......#.#
#..#########.#...#####.#...#####.#############.#...#.#...#####
#......#.......#.#...........#...................#.#...#.#...#
####.#...#####.#...#########.#########.#...#.#...#.#####.#####
#......#.#.......#...........#.#.......#.#...#.......#.#.....#
#.######.#...#####.#...###.#.#...#.#...#.#########.###########
#......#.......#.......#.......#.#...#.#...#...........#.#...#
####.#########.#########.#...#.#...#.#############.#...#.#...#
#..............#.......#...................#...........#.....#
###########....#.#...#################.#...#################.#
#..............#.#...#...................#.#...........#.....#
#..#############.#...#.#################.#...#####.#...#.#...#
#..#.#...........#.#.......#...........#.#.......#.......#.#.#
#..#.#...#########.#########.#####.#...#########.#####.#...#.#
#..#.#...#.......#...........#.......#.......#.......#.#.....#
#..#.#...#.#...#########.#####.#########.#...#####.#####.#####
#..#.#...#.#...#.......#...........#.......#.#...#.......#...#
#..#.#...#.#...#.#...#####.#####.#...#.#...#.#####.###########
#..#.#...#.#...#.#.......#...........#.......#.......#.#...#.#
#..#.#...#.#####.#####.#############################.#...#.###
#..#...........#.......#.......#...............#.............#
#..#########.#...#####.#########.#####.#...#################.#
#..........#.#...#.#...........#.#.......#.#...............#.#
#######....#####.#...#########.#####.#...#.#############.#...#
#......#.......#.#.......#.......#.......#.#.......#.......#.#
#.##########.#...#####.#...#####.#############.#...#.#...#####
#......#.......#.#...........#...................#.#...#.#...#
#..#.#...#####.#...#########.#########.#...#.#...#.#####.#####
#......#.#.......#...........#.#.......#.#...#.......#.#.....#
#..............#.......#...................#...........#.....#
###########....#.#...#################.#...#################.#
#..............#.#...#...................#.#...........#.....#
#..#############.#...#.#################.#...#####.#...#.#...#
#..#.#...........#.#.......#...........#.#.......#.......#.#.#
#..#.#...#########.#########.#####.#...#########.#####.#...#.#
#..#.#...#.......#...........#.......#.......#.......#.#.....#
#..#.#...#.#...#########.#####.#########.#...#####.#####.#####
#..#.#...#.#...#.......#...........#.......#.#...#.......#...#
#..#.#...#.#...#.#...#####.#####.#...#.#...#.#####.###########
#..#.#...#.#...#.#.......#...........#.......#.......#.#...#.#
#..#.#...#.#####.#####.#############################.#...#.###
#..#...........#.......#.......#...............#.............#
#..#########.#...#####.#########.#####.#...#################.#
#..........#.#...#.#...........#.#.......#.#...............#.#
#..#.#########.#########.#...#.#...#.#############.#...#.#.#.#
#......#.......#.......#.......#.#...#.#...#...........#.#...#
#..#.#######.#.#########.#...#.#...#.#############.#...#.#.#.#
#..............#.......#.......#.#...#.#...#...........#.#...#
#..#.#########.#########.#...#.#...#.#############.#...#.#.#.#
#..#.......................#...........#.#.......#.......#.E.#
##############################################################

> 