###########
#S........#
#.#####.#.#
#.#.....#.#
#...#.#.#.#
#.###.#.#.#
#.#...#.#.#
#.#.#######
#.#......E#
###########
